################################################################
#############################...........########################
######.P...##################........E..########################
######......K....L..........###.........#...####################
######..MM.#######......... L X...E.......M.####################
#####X.....#######...K......###.........#...####################
##################...########...........########################
######.........###...########...........########################
######.........###...#############D#############################
######.........#......E##########...############################
######....E....D...E...##########...############################
######.........#.......##########...############################
######....E....##################...############################
#...##.........##################...############################
#.K.######D######################...############################
#...#####...###############...#E.....K##########################
##D######...###############..####...############################
#...#####...###############..####...############################
#...#...#...###############..####...############################
#...D...#...#####################...############################
#...#...#...#####################...############################
#...######D#######################L#############################
#.E.##.........#################.....#################........##
#...##.........############...............############........##
#...##...E.....############...............############........##
#....#.........############...E.......E....#.........#........##
#....L....K....############................D....E....D....E...##
#....#.........############................#.........#........##
#...##.....E...############...............####....####........##
#...##.........############...............#####..#####.....M..##
#...##.........#################.....##########..#####........##
#...######L#######################D############..###############
#...#####...#####################...###########..###############
#E.E#####...#####################...###########..###############
#...#...#...#####################.E.###########..###############
#...D.M.#...#####################...###########..###############
#...#...#...#####################...###########..###.#.#.#.#####
#...#####...#####################...###########...#.........####
#...#####...#####################...###########...D....E..K.####
#................##......########...###########...#.........####
#....E........E...L...E...X######...################.#.#.#.#####
#................##......########...############################
#################################...############################
#############..#..#..#############L#############################
###########....#..#.########....#...#....#######################
#############.....##########....D...D....#######################
############################....#...#....#######################
##############..#################...############################
##############..############....#...#....#######################
############################....D...D....#######################
############################....#...#....#######################
#################################...############################
############################.............#######################
############################..........EK.#######################
############################.............#######################
################################################################
